DEEEEEEEEE
EEEEEEEEEE
EEEEEEEEEE
EEWWWWWWEE
EEEEEEEEEE
EEEEEEEEAE
EEEEEEEEEE
EEEEEEEEEE
EEEEEEEEEE
EEEEEEEEEE
