DEEEEEEEEE
EEWEEEEEEE
EEWEEEEEEE
EEWEEEEEEE
EEWEEEEEEE
EEEEEEEEEE
EEEEEEAEEE
EEEEEEEEEE
EEEEEEEEEE
EEEEEEEEEE
